I (to be) #WHOSE_WITHOUT_IT# #FAMILY_MEMBERS_SINGLE_FULL#	I am #WHOSE_WITHOUT_IT# #FAMILY_MEMBERS_SINGLE_FULL#.
You (to be) #WHOSE_WITHOUT_IT# #FAMILY_MEMBERS_SINGLE_FULL#	You are #WHOSE_WITHOUT_IT# #FAMILY_MEMBERS_PLURAL_FULL#.
#WHO_PLURAL# (to be) #WHOSE_WITHOUT_IT# #FAMILY_MEMBERS_PLURAL_FULL#	#WHO_PLURAL# are #WHOSE_WITHOUT_IT# #FAMILY_MEMBERS_PLURAL_FULL#.
He (to be) #WHOSE_WITHOUT_IT# #FAMILY_MEMBERS_MEN_SINGLE_FULL#	He is #WHOSE_WITHOUT_IT# #FAMILY_MEMBERS_MEN_SINGLE_FULL#.
She (to be) #WHOSE_WITHOUT_IT# #FAMILY_MEMBERS_WOMEN_SINGLE_FULL#.	She is #WHOSE_WITHOUT_IT# #FAMILY_MEMBERS_WOMEN_SINGLE_FULL#.
#NAMES_FIRST_MEN# (to be) #WHOSE_WITHOUT_IT# #FAMILY_MEMBERS_MEN_SINGLE_FULL#	#NAMES_FIRST_MEN# is #WHOSE_WITHOUT_IT# #FAMILY_MEMBERS_MEN_SINGLE_FULL#.
#NAMES_FIRST_WOMEN# (to be) #WHOSE_WITHOUT_IT# #FAMILY_MEMBERS_WOMEN_SINGLE_FULL#	#NAMES_FIRST_WOMEN# is #WHOSE_WITHOUT_IT# #FAMILY_MEMBERS_WOMEN_SINGLE_FULL#.
I not (to be) #WHOSE_WITHOUT_IT# #FAMILY_MEMBERS_SINGLE_FULL#	I am not #WHOSE_WITHOUT_IT# #FAMILY_MEMBERS_SINGLE_FULL#.
You not (to be) #WHOSE_WITHOUT_IT# #FAMILY_MEMBERS_SINGLE_FULL#	You are not #WHOSE_WITHOUT_IT# #FAMILY_MEMBERS_SINGLE_FULL#.
#WHO_PLURAL# not (to be) #WHOSE_WITHOUT_IT# #FAMILY_MEMBERS_PLURAL_FULL#	#WHO_PLURAL# are not #WHOSE_WITHOUT_IT# #FAMILY_MEMBERS_PLURAL_FULL#.
He not (to be) #WHOSE_WITHOUT_IT# #FAMILY_MEMBERS_MEN_SINGLE_FULL#	He is not #WHOSE_WITHOUT_IT# #FAMILY_MEMBERS_MEN_SINGLE_FULL#.
She not (to be) #WHOSE_WITHOUT_IT# #FAMILY_MEMBERS_WOMEN_SINGLE_FULL#.	She is not #WHOSE_WITHOUT_IT# #FAMILY_MEMBERS_WOMEN_SINGLE_FULL#.
#NAMES_FIRST_MEN# not (to be) #WHOSE_WITHOUT_IT# #FAMILY_MEMBERS_MEN_SINGLE_FULL#	#NAMES_FIRST_MEN# is not #WHOSE_WITHOUT_IT# #FAMILY_MEMBERS_MEN_SINGLE_FULL#.
#NAMES_FIRST_WOMEN# not (to be) #WHOSE_WITHOUT_IT# #FAMILY_MEMBERS_WOMEN_SINGLE_FULL#	#NAMES_FIRST_WOMEN# is not #WHOSE_WITHOUT_IT# #FAMILY_MEMBERS_WOMEN_SINGLE_FULL#.
Question: I (to be) #WHOSE_WITHOUT_IT# #FAMILY_MEMBERS_SINGLE_FULL#?	Am I #WHOSE_WITHOUT_IT# #FAMILY_MEMBERS_SINGLE_FULL#?
Question: You (to be) #WHOSE_WITHOUT_IT# #FAMILY_MEMBERS_SINGLE_FULL#?	Are you #WHOSE_WITHOUT_IT# #FAMILY_MEMBERS_SINGLE_FULL#?
Question: #WHO_PLURAL# (to be) #WHOSE_WITHOUT_IT# #FAMILY_MEMBERS_PLURAL_FULL#?	Are #WHO_PLURAL# #WHOSE_WITHOUT_IT# #FAMILY_MEMBERS_PLURAL_FULL#?
Question: He (to be) #WHOSE_WITHOUT_IT# #FAMILY_MEMBERS_MEN_SINGLE_FULL#?	Is he #WHOSE_WITHOUT_IT# #FAMILY_MEMBERS_MEN_SINGLE_FULL#?
Question: She (to be) #WHOSE_WITHOUT_IT# #FAMILY_MEMBERS_WOMEN_SINGLE_FULL#?	Is she #WHOSE_WITHOUT_IT# #FAMILY_MEMBERS_WOMEN_SINGLE_FULL#?
Question: #NAMES_FIRST_MEN# (to be) #WHOSE_WITHOUT_IT# #FAMILY_MEMBERS_MEN_SINGLE_FULL#?	Is #NAMES_FIRST_MEN# #WHOSE_WITHOUT_IT# #FAMILY_MEMBERS_MEN_SINGLE_FULL#?
Question: #NAMES_FIRST_WOMEN# (to be) #WHOSE_WITHOUT_IT# #FAMILY_MEMBERS_WOMEN_SINGLE_FULL#?	Is #NAMES_FIRST_WOMEN# #WHOSE_WITHOUT_IT# #FAMILY_MEMBERS_WOMEN_SINGLE_FULL#?
